#tileset
Resources/tileset1.bmp
12 1
tile0: mur
tile1: ciel
tile2: ciel
tile3: ciel
tile4: ciel
tile5: ciel
tile6: ciel
tile7: ciel
tile8: ciel
tile9: ciel
tile10: ciel
tile11: ciel
#level
16 14
2 1 2 1 2 1 2 1 2 1 2 1 2 1 2 1
7 5 4 3 4 3 4 3 4 3 4 3 4 3 5 9
8 6 2 1 2 1 2 1 2 1 2 1 2 1 6 10
0 0 0 0 0 0 4 3 4 3 0 0 0 0 0 0
2 1 2 1 2 1 2 1 2 1 2 1 2 1 2 1
4 3 4 3 4 3 4 3 4 3 4 3 4 3 4 3
2 1 2 1 0 0 0 0 0 0 0 0 2 1 2 1
0 0 4 3 4 3 4 3 4 3 4 3 4 3 0 0
2 1 2 1 2 1 2 1 2 1 2 1 2 1 2 1
4 3 4 3 4 3 4 3 4 3 4 3 4 3 4 3
0 0 0 0 0 0 2 1 2 1 0 0 0 0 0 0
7 5 4 3 4 3 4 3 4 3 4 3 4 3 5 9
8 6 2 1 2 1 2 1 2 1 2 1 2 1 6 10
11 11 11 11 11 11 11 11 11 11 11 11 11 11 11 11
